1111111111111111111111
1110000000000011000001
11E0P000000C00000C0011
1110000C000000000000C1
1111111111111111111111