11111111111111111111111111
10P000000000000000000C0001
100000011110A0011111111001
10000011011000110000011001
10000110011001100C00110001
10001100011000000001100001
100110000CC000000011000001
10111C1111111000011000C001
10C000000110000011000A0001
10000000011000011000000001
10000C0001100011000000C001
10000000011000111111111101
10A0000C000000A000000000E1
11111111111111111111111111